@@@@@@@@@@@@@@@@@@@@@@@@@@@@
@************@@************@
@*@@@@*@@@@@*@@*@@@@@*@@@@*@
@*@  @*@   @*@@*@   @*@  @*@
@*@@@@*@@@@@*@@*@@@@@*@@@@*@
@**************************@
@*@@@@*@@*@@@@@@@@*@@*@@@@*@
@*@@@@*@@*@@@@@@@@*@@*@@@@*@
@******@@****@@****@@******@
@@@@@@*@@@@@ @@ @@@@@*@@@@@@
@    @*@@@@@ @@ @@@@@*@    @
@    @*@@          @@*@    @
@    @*@@          @@*@    @
@@@@@@*@@          @@*@@@@@@
T     *              *     T
@@@@@@*@@          @@*@@@@@@
@    @*@@          @@*@    @
@    @*@@          @@*@    @
@    @*@@ @@@@@@@@ @@*@    @
@@@@@@*@@ @@@@@@@@ @@*@@@@@@
@************@@************@
@*@@@@*@@@@@*@@*@@@@@*@@@@*@
@*@@@@*@@@@@*@@*@@@@@*@@@@*@
@***@@****************@@***@
@@@*@@*@@*@@@@@@@@*@@*@@*@@@
@@@*@@*@@*@@@@@@@@*@@*@@*@@@
@******@@****@@****@@******@
@*@@@@@@@@@@*@@*@@@@@@@@@@*@
@*@@@@@@@@@@*@@*@@@@@@@@@@*@
@**************************@
@@@@@@@@@@@@@@@@@@@@@@@@@@@@

